4
1 1
9
2 2
0 0
0 0
20 20
1 4 5 7 8 9 7 5 3 4 6 7 4 3 6 8 4 3 5 9
2 4 0 9 7 5 4 6 7 8 4 3 1 4 6 7 8 9 6 5
1 2 3 4 6 6 8 9 9 0 0 0 0 0 3 4 5 4 3 1
1 4 5 7 8 9 7 5 3 4 6 7 4 3 6 8 4 3 5 9
2 4 0 9 7 5 4 6 7 8 4 3 1 4 6 7 8 9 6 5
1 2 3 4 5 6 7 8 9 9 0 6 4 3 2 4 5 6 7 8
8 5 9 2 4 5 6 7 8 9 2 1 2 3 4 5 6 8 9 0
9 9 9 0 0 0 0 0 1 2 3 4 6 7 8 9 0 5 4 3
1 2 3 4 5 6 7 8 9 9 0 6 4 3 2 4 5 6 7 8
1 4 5 7 8 9 7 5 3 4 6 7 4 3 6 8 4 3 5 9
1 3 5 7 8 9 2 2 2 2 3 4 4 4 4 5 6 7 8 9
0 9 9 8 7 6 9 9 9 9 9 9 9 0 0 0 0 0 9 9
1 2 3 4 5 6 7 8 9 9 0 6 4 3 2 4 5 6 7 8
8 5 9 2 4 5 6 7 8 9 2 1 2 3 4 5 6 8 9 0
1 2 3 4 6 6 8 9 9 0 0 0 0 0 3 4 5 4 3 1
1 4 5 7 8 9 7 5 3 4 6 7 4 3 6 8 4 3 5 9
1 2 3 4 5 6 7 8 9 5 3 2 4 5 6 7 8 9 9 6
1 2 3 4 5 6 7 8 9 9 0 6 4 3 2 4 5 6 7 8
0 0 0 0 0 0 1 1 1 1 2 3 3 3 3 3 4 4 4 4
3 3 3 1 1 1 1 1 3 4 5 6 7 8 9 0 5 4 3 1
22 20
1 4 5 7 8 9 7 5 3 4 6 7 4 3 6 8 4 3 5 9
2 4 0 9 7 5 4 6 7 8 4 3 1 4 6 7 8 9 6 5
1 2 3 4 6 6 8 9 9 0 0 0 0 0 3 4 5 4 3 1
1 4 5 7 8 9 7 5 3 4 6 7 4 3 6 8 4 3 5 9
2 4 0 9 7 5 4 6 7 8 4 2 2 2 2 2 8 9 6 5
1 2 3 4 5 6 7 8 9 9 0 6 4 3 2 4 0 6 7 8
1 5 9 2 4 5 6 7 8 9 2 1 2 3 4 5 6 8 9 0
9 9 9 0 0 0 0 0 1 2 3 4 6 7 8 9 0 5 4 3
1 2 3 4 5 6 7 8 9 9 0 6 4 0 0 0 5 6 7 8
1 4 5 7 8 9 7 5 3 4 6 7 4 0 0 0 4 3 5 9
1 3 5 7 8 9 2 2 0 2 3 4 4 0 0 0 6 4 8 9
0 9 9 8 7 6 9 9 9 9 9 9 9 0 0 0 2 0 9 9
1 2 3 4 5 6 7 8 9 9 0 6 4 3 2 4 5 6 7 8
8 5 9 2 4 5 6 7 8 9 2 1 2 3 4 5 6 8 9 0
1 2 3 4 6 6 8 9 0 0 0 0 0 0 3 4 5 4 3 1
1 4 5 7 8 9 7 5 3 4 6 7 4 3 6 8 4 3 5 9
1 2 3 4 5 6 7 8 9 5 3 2 4 5 6 7 8 9 9 6
1 2 3 4 5 6 7 8 9 9 0 6 4 3 2 4 5 6 7 8
0 0 0 0 0 0 1 1 1 1 2 3 3 3 3 3 4 4 4 4
3 3 3 1 1 1 1 1 3 4 5 6 7 8 9 0 5 4 3 1
8 5 9 2 4 5 6 7 8 9 2 1 2 3 4 5 6 8 9 0
1 2 3 4 6 6 8 9 9 0 0 0 0 0 3 4 5 4 3 1